###################
#********#********#
#*##*###*#*###*##*#
#*##*###*#*###*##*#
#*****************#
#*##*#*#####*#*##*#
#****#***#***#****#
####*###-#-###*####
####*#-------#*####
####*#-#####-#*####
----*--#---#--*----
####*#-#####-#*####
####*#-------#*####
####*#-#####-#*####
#********#********#
#*##*###*#*###*##*#
#**#*****C*****#**#
##*#*#*#####*#*#*##
#****#***#***#****#
#*######*#*######*#
#*****************#
###################