###################
#--------#--------#
#-##-###-#-###-##-#
#-##-###-#-###-##-#
#-----------------#
#-##-#-#####-#-##-#
#----#---#---#----#
####-###-#-###-####
####-#-------#-####
####-#-#####-#-####
#------#---#------#
####-#-#####-#-####
####-#-------#-####
####-#-------#-####
####-#-#####-#-####
#--------#--------#
#-##-###-#-###-##-#
#--#-----C-----#--#
#--#-#-#####-#-#--#
#----#---#---#----#
#-######-#-######-#
#--------#--------#
###################